14,10
---X------
OOOX----D-
---x--x---
---x--x-D-
---x--x---
---x--x-D-
------x---
xxxx--xxxx
----------
----------
----------
-----^----
----------
----------
