14,10
---X------
OOOX----D-
---X--X---
---X--X-D-
---X--X---
---X--X-D-
------X---
XXXX--XXXX
----------
----------
----------
-----^----
----------
----------
